20,13,21,22,23,18,19,20,10,14,15,16,17,14,21,22,23,18,19,20,10,15,16,17,21,22,23,21,22,23,15,16
23,01,07,02,10,21,22,23,10,10,18,19,20,10,10,10,10,21,22,23,10,18,19,20,10,14,10,01,07,02,18,19
17,03,09,04,10,10,13,10,10,10,21,22,23,10,30,31,32,14,10,14,10,21,22,23,10,01,02,03,09,04,21,22
20,08,05,06,01,07,02,10,10,10,10,01,02,10,33,12,34,10,10,15,16,17,14,10,10,08,06,08,05,06,10,14
23,10,10,10,08,05,06,15,16,17,10,08,06,10,35,11,37,10,10,18,19,20,10,13,10,10,10,10,10,10,15,16
17,01,02,10,10,14,10,18,19,20,10,10,10,01,02,10,01,07,02,21,22,23,10,10,01,02,10,01,02,10,18,19
20,08,06,10,10,01,02,21,22,23,14,10,13,08,06,10,08,05,06,10,13,10,10,10,08,06,10,03,04,10,21,22
23,10,10,01,02,08,06,10,10,15,16,17,10,10,10,10,10,10,10,14,10,10,10,10,10,10,10,03,04,10,10,15
17,13,10,03,04,10,10,10,10,18,19,20,10,10,01,02,10,15,16,17,10,14,10,01,07,02,10,08,06,10,10,18
20,10,10,03,04,13,10,10,14,21,22,23,10,10,03,04,10,18,19,20,10,10,10,08,05,06,10,10,15,16,17,21
23,10,10,08,06,10,10,01,07,02,15,16,17,14,03,04,10,21,22,23,10,01,02,10,10,10,14,10,18,19,20,10
16,17,14,10,10,01,02,08,05,06,18,19,20,10,08,06,27,15,16,17,14,03,04,10,10,01,02,10,21,22,23,14
19,20,10,10,10,08,06,10,10,10,21,22,23,01,02,10,10,18,19,20,10,08,06,10,10,08,06,10,15,16,17,10
22,23,14,15,16,17,10,10,10,01,07,02,10,08,06,10,10,21,22,23,01,02,10,10,10,15,16,17,18,19,20,10
15,16,17,18,19,20,10,13,10,08,05,06,10,10,10,01,02,10,10,10,08,06,10,10,10,18,19,20,21,22,23,10
18,19,20,21,22,23,15,16,17,10,10,10,01,02,10,03,04,01,07,02,10,10,10,10,10,21,22,23,15,16,17,10
21,22,23,15,16,17,18,19,20,10,10,13,08,06,10,03,04,08,05,06,15,16,17,13,10,10,14,10,18,19,20,10
15,16,17,18,19,20,21,22,23,10,26,10,10,10,10,03,04,10,25,10,18,19,20,15,16,17,15,16,21,22,23,10
18,19,20,21,22,23,15,16,17,15,16,17,14,10,10,08,06,10,10,10,21,22,23,18,19,20,18,19,20,14,10,10
21,22,23,15,16,17,18,19,20,18,19,20,10,10,01,02,10,10,14,10,10,15,16,21,22,23,21,22,23,15,16,17
15,16,17,18,19,20,21,22,23,21,22,23,10,10,03,04,10,10,15,16,17,18,19,20,15,16,17,10,10,18,19,20
18,19,20,21,22,23,13,15,16,17,10,10,10,10,03,04,14,10,18,19,20,21,22,23,18,19,20,10,13,21,22,23
21,22,23,14,15,16,17,18,19,20,10,13,10,10,03,04,10,10,21,22,23,16,17,13,21,22,23,10,10,10,15,16
17,15,16,17,18,19,20,21,22,23,10,10,10,10,08,06,10,01,07,02,18,19,20,15,16,17,10,15,16,17,18,19
20,18,19,20,21,22,23,13,15,16,17,10,01,07,07,07,02,08,05,06,21,22,23,18,19,20,10,18,19,20,21,22
23,21,22,23,10,15,16,17,18,19,20,10,08,05,05,05,06,10,10,10,15,16,17,21,22,23,13,21,22,23,10,10
15,16,17,10,10,18,19,20,21,22,23,01,02,01,07,07,07,07,02,10,18,19,20,13,10,10,15,16,17,15,16,17
18,19,20,13,10,21,22,23,14,10,10,08,06,03,09,24,09,09,04,10,21,22,23,10,10,10,18,19,20,18,19,20
21,22,23,10,10,10,15,16,17,10,10,14,10,08,05,05,05,05,06,01,02,15,16,17,13,10,21,22,23,21,22,23
10,10,10,15,16,17,18,19,20,13,10,10,01,07,02,10,28,10,10,08,06,18,19,20,15,16,17,13,10,10,10,10
16,17,14,18,19,20,21,22,23,15,16,17,08,05,06,10,10,13,15,16,17,21,22,23,18,19,20,10,15,16,17,10
19,20,10,21,22,23,10,10,10,18,19,20,15,16,17,14,13,10,18,19,20,10,10,10,21,22,23,10,18,19,20,10

20,13,21,22,23,18,19,20,00,14,15,16,17,14,21,22,23,18,19,20,00,15,16,17,21,22,23,21,22,23,15,16
23,00,00,00,00,21,22,23,10,10,18,19,20,00,00,00,00,21,22,23,00,18,19,20,00,14,00,00,00,00,18,19
17,00,00,00,00,00,13,10,10,10,21,22,23,00,30,31,32,14,00,14,00,21,22,23,00,00,00,00,00,00,21,22
20,00,00,00,00,00,00,13,10,10,00,00,00,00,33,00,34,00,00,15,16,17,14,00,00,00,00,00,00,00,00,14
23,00,00,00,00,00,00,15,16,17,00,00,00,00,35,36,37,00,00,18,19,20,00,13,00,00,00,00,00,00,15,16
17,00,00,00,00,14,00,18,19,20,00,00,00,00,00,00,00,00,00,21,22,23,00,00,00,00,00,00,00,00,18,19
20,00,00,00,00,00,00,21,22,23,14,00,13,00,00,00,00,00,00,00,13,00,00,00,00,00,00,00,00,00,21,22
23,00,00,00,00,00,00,00,00,15,16,17,00,00,00,00,00,00,00,14,00,00,00,00,00,00,00,00,00,00,00,15
17,13,00,00,00,00,00,00,00,18,19,20,00,00,00,00,00,15,16,17,00,14,00,00,00,00,00,00,00,00,00,18
20,00,00,00,00,13,00,00,14,21,22,23,00,00,00,00,00,18,19,20,00,00,00,00,00,00,00,00,15,16,17,21
23,00,00,00,00,00,00,00,00,00,15,16,17,14,00,00,00,21,22,23,00,00,00,00,00,00,14,00,18,19,20,00
16,17,14,00,00,00,00,00,00,00,18,19,20,00,00,00,27,15,16,17,14,00,00,00,00,00,00,00,21,22,23,14
19,20,00,00,00,00,00,00,00,00,21,22,23,00,00,00,00,18,19,20,00,00,00,00,00,00,00,00,15,16,17,00
22,23,14,15,16,17,00,00,00,00,00,00,00,00,00,00,00,21,22,23,00,00,00,00,00,15,16,17,18,19,20,00
15,16,17,18,19,20,00,13,00,00,00,00,00,00,00,00,00,00,00,00,00,00,00,00,00,18,19,20,21,22,23,00
18,19,20,21,22,23,15,16,17,00,00,00,00,00,00,00,00,00,00,00,00,00,00,00,00,21,22,23,15,16,17,00
21,22,23,15,16,17,18,19,20,00,00,13,00,00,00,00,00,00,00,00,15,16,17,13,00,00,14,00,18,19,20,00
15,16,17,18,19,20,21,22,23,00,26,00,00,00,00,00,00,00,25,00,18,19,20,15,16,17,15,16,21,22,23,00
18,19,20,21,22,23,15,16,17,15,16,17,14,00,00,00,00,00,00,00,21,22,23,18,19,20,18,19,20,14,00,00
21,22,23,15,16,17,18,19,20,18,19,20,00,00,00,00,00,00,14,00,00,15,16,21,22,23,21,22,23,15,16,17
15,16,17,18,19,20,21,22,23,21,22,23,00,00,00,00,00,00,15,16,17,18,19,20,15,16,17,00,00,18,19,20
18,19,20,21,22,23,13,15,16,17,00,00,00,00,00,00,14,00,18,19,20,21,22,23,18,19,20,00,13,21,22,23
21,22,23,14,15,16,17,18,19,20,00,13,00,00,00,00,00,00,21,22,23,16,17,13,21,22,23,00,00,00,15,16
17,15,16,17,18,19,20,21,22,23,00,00,00,00,00,00,00,00,00,00,18,19,20,15,16,17,00,15,16,17,18,19
20,18,19,20,21,22,23,13,15,16,17,00,00,00,00,00,00,00,00,00,21,22,23,18,19,20,00,18,19,20,21,22
23,21,22,23,00,15,16,17,18,19,20,00,00,00,00,00,00,00,00,00,15,16,17,21,22,23,13,21,22,23,00,00
15,16,17,00,00,18,19,20,21,22,23,00,00,00,00,00,00,00,00,00,18,19,20,13,00,00,15,16,17,15,16,17
18,19,20,13,00,21,22,23,14,00,00,00,00,00,00,24,00,00,00,00,21,22,23,00,00,00,18,19,20,18,19,20
21,22,23,00,00,00,15,16,17,00,00,14,00,00,00,00,00,00,00,00,00,15,16,17,13,00,21,22,23,21,22,23
00,00,00,15,16,17,18,19,20,13,00,00,00,00,00,00,28,00,00,00,00,18,19,20,15,16,17,13,00,00,00,00
16,17,14,18,19,20,21,22,23,15,16,17,00,00,00,00,00,13,15,16,17,21,22,23,18,19,20,00,15,16,17,00
19,20,00,21,22,23,00,00,00,18,19,20,15,16,17,14,13,00,18,19,20,00,00,00,21,22,23,00,18,19,20,00

00,00,00,00,00,00,00,00,00,00,00,00,00,00,00,00,00,00,00,00,00,00,00,00,00,00,00,00,00,00,00,00
00,00,00,00,00,00,00,00,00,00,00,00,00,00,00,00,00,00,00,00,00,00,00,00,00,00,00,00,00,00,00,00
00,00,29,00,00,00,00,00,00,00,00,00,00,00,00,00,00,00,00,00,00,00,00,00,00,00,00,00,39,00,00,00
00,00,00,00,00,00,00,00,00,00,00,00,00,00,00,38,00,00,00,00,00,00,00,00,00,00,00,00,00,00,00,00
00,00,00,00,00,00,00,00,00,00,00,00,00,00,00,00,00,00,00,00,00,00,00,00,00,00,00,00,00,00,00,00
00,00,00,00,00,00,00,00,00,00,00,00,00,00,00,00,00,00,00,00,00,00,00,00,00,00,00,00,00,00,00,00
00,00,00,00,00,00,00,00,00,00,00,00,00,00,00,00,00,00,00,00,00,00,00,00,00,00,00,00,00,00,00,00
00,00,00,00,00,00,00,00,00,00,00,00,00,00,00,00,00,00,00,00,00,00,00,00,00,00,00,00,00,00,00,00
00,00,00,00,00,00,00,00,00,00,00,00,00,00,00,00,00,00,00,00,00,00,00,00,00,00,00,00,00,00,00,00
00,00,00,00,00,00,00,00,00,00,00,00,00,00,00,00,00,00,00,00,00,00,00,00,00,00,00,00,00,00,00,00
00,00,00,00,00,00,00,00,00,00,00,00,00,00,00,00,00,00,00,00,00,00,00,00,00,00,00,00,00,00,00,00
00,00,00,00,00,00,00,00,00,00,00,00,00,00,00,00,00,00,00,00,00,00,00,00,00,00,00,00,00,00,00,00
00,00,00,00,00,00,00,00,00,00,00,00,00,00,00,00,00,00,00,00,00,00,00,00,00,00,00,00,00,00,00,00
00,00,00,00,00,00,00,00,00,00,00,00,00,00,00,00,00,00,00,00,00,00,00,00,00,00,00,00,00,00,00,00
00,00,00,00,00,00,00,00,00,00,00,00,00,00,00,00,00,00,00,00,00,00,00,00,00,00,00,00,00,00,00,00
00,00,00,00,00,00,00,00,00,00,00,00,00,00,00,00,00,00,00,00,00,00,00,00,00,00,00,00,00,00,00,00
00,00,00,00,00,00,00,00,00,00,00,00,00,00,00,00,00,00,00,00,00,00,00,00,00,00,00,00,00,00,00,00
00,00,00,00,00,00,00,00,00,00,00,00,00,00,00,00,00,00,00,00,00,00,00,00,00,00,00,00,00,00,00,00
00,00,00,00,00,00,00,00,00,00,00,00,00,00,00,00,00,00,00,00,00,00,00,00,00,00,00,00,00,00,00,00
00,00,00,00,00,00,00,00,00,00,00,00,00,00,00,00,00,00,00,00,00,00,00,00,00,00,00,00,00,00,00,00
00,00,00,00,00,00,00,00,00,00,00,00,00,00,00,00,00,00,00,00,00,00,00,00,00,00,00,00,00,00,00,00
00,00,00,00,00,00,00,00,00,00,00,00,00,00,00,00,00,00,00,00,00,00,00,00,00,00,00,00,00,00,00,00
00,00,00,00,00,00,00,00,00,00,00,00,00,00,00,00,00,00,00,00,00,00,00,00,00,00,00,00,00,00,00,00
00,00,00,00,00,00,00,00,00,00,00,00,00,00,00,00,00,00,00,00,00,00,00,00,00,00,00,00,00,00,00,00
00,00,00,00,00,00,00,00,00,00,00,00,00,00,00,00,00,00,00,00,00,00,00,00,00,00,00,00,00,00,00,00
00,00,00,00,00,00,00,00,00,00,00,00,00,00,00,00,00,00,00,00,00,00,00,00,00,00,00,00,00,00,00,00
00,00,00,00,00,00,00,00,00,00,00,00,00,00,00,00,00,00,00,00,00,00,00,00,00,00,00,00,00,00,00,00
00,00,00,00,00,00,00,00,00,00,00,00,00,00,00,00,00,00,00,00,00,00,00,00,00,00,00,00,00,00,00,00
00,00,00,00,00,00,00,00,00,00,00,00,00,00,00,00,00,00,00,00,00,00,00,00,00,00,00,00,00,00,00,00
00,00,00,00,00,00,00,00,00,00,00,00,00,00,00,00,00,00,00,00,00,00,00,00,00,00,00,00,00,00,00,00
00,00,00,00,00,00,00,00,00,00,00,00,00,00,00,00,00,00,00,00,00,00,00,00,00,00,00,00,00,00,00,00
00,00,00,00,00,00,00,00,00,00,00,00,00,00,00,00,00,00,00,00,00,00,00,00,00,00,00,00,00,00,00,00